20
########################################
#                 # ##### #            #
# ############# # #       # ## ####### #
# #       #     # # # ### # ##         #
# # ##### # ##### # # ### # ########## #
# # #   # #       # #        #         #
# # # # # ####### # ########### ########
# # # # #         #                  ###
# # # # # ####### ########## ###########
#                                      #
# ### ########### ########## ######### #
#   #                                  #
# # ######### ######### #### # ##### # #
# #         # ######### ####   ##### # #
# # ####### #         #      #       # #
# # #     # ######### # ############## #
# # # ### #   #   #   #          ##### #
# # # ### # #   #   # ###### ##        #
#           #########        ###########
########################################
