5
#########
#   #   #
# # # # #
# #   # #
#########